//MAP CONVERTED BY dmm2tgm.py THIS HEADER COMMENT PREVENTS RECONVERSION, DO NOT REMOVE
"aq" = (
/obj/effect/turf_decal/trimline/yellow/filled/line,
/obj/effect/turf_decal/trimline/yellow/filled/line{
	dir = 1
	},
/turf/open/floor/oldshuttle,
/area/shuttle/escape)
"bk" = (
/turf/closed/indestructible/oldshuttle{
	icon_state = "orange"
	},
/area/shuttle/escape)
"bB" = (
/obj/effect/turf_decal/trimline/red/filled/corner{
	dir = 8
	},
/turf/open/floor/oldshuttle,
/area/shuttle/escape/brig)
"ef" = (
/obj/machinery/power/shuttle_engine/propulsion/burst/right,
/turf/open/floor/plating/airless,
/area/shuttle/escape)
"ga" = (
/obj/machinery/power/shuttle_engine/propulsion/burst{
	dir = 1
	},
/turf/open/floor/plating/airless,
/area/shuttle/escape)
"ir" = (
/obj/structure/chair/old{
	dir = 8
	},
/obj/effect/turf_decal/trimline/dark_blue/filled/line,
/obj/effect/turf_decal/trimline/dark_blue/filled/line{
	dir = 1
	},
/turf/open/floor/oldshuttle,
/area/shuttle/escape)
"je" = (
/obj/machinery/door/airlock/public/glass,
/obj/structure/fans/tiny,
/obj/docking_port/mobile/emergency{
	dir = 1;
	name = "NTS Soul emergency shuttle"
	},
/turf/open/floor/oldshuttle,
/area/shuttle/escape)
"jk" = (
/obj/machinery/recharge_station,
/obj/effect/turf_decal/trimline/yellow/filled/line{
	dir = 6
	},
/turf/open/floor/oldshuttle,
/area/shuttle/escape)
"jz" = (
/obj/machinery/power/shuttle_engine/propulsion/burst,
/obj/machinery/power/shuttle_engine/propulsion/burst,
/turf/open/floor/plating/airless,
/area/shuttle/escape)
"jA" = (
/obj/machinery/computer/emergency_shuttle,
/obj/effect/turf_decal/trimline/dark_blue/filled/line{
	dir = 1
	},
/obj/effect/turf_decal/trimline/dark_blue/filled/line{
	dir = 1
	},
/obj/machinery/light/no_nightlight/directional/north,
/turf/open/floor/oldshuttle,
/area/shuttle/escape)
"jC" = (
/obj/effect/turf_decal/trimline/yellow/filled/line{
	dir = 1
	},
/obj/effect/turf_decal/trimline/yellow/filled/line,
/turf/open/floor/oldshuttle,
/area/shuttle/escape)
"kq" = (
/obj/effect/turf_decal/trimline/blue/filled/line{
	dir = 4
	},
/obj/machinery/sleeper/old,
/turf/open/floor/oldshuttle,
/area/shuttle/escape)
"kv" = (
/obj/effect/turf_decal/trimline/red/filled/line{
	dir = 1
	},
/obj/machinery/light/no_nightlight/directional/north,
/turf/open/floor/oldshuttle,
/area/shuttle/escape/brig)
"kW" = (
/obj/effect/turf_decal/trimline/red/filled/corner{
	dir = 4
	},
/turf/open/floor/oldshuttle,
/area/shuttle/escape/brig)
"mk" = (
/obj/effect/turf_decal/trimline/dark_blue/filled/line,
/obj/effect/turf_decal/trimline/dark_blue/filled/corner{
	dir = 4
	},
/turf/open/floor/oldshuttle,
/area/shuttle/escape)
"mn" = (
/obj/effect/turf_decal/trimline/yellow/filled/line{
	dir = 1
	},
/obj/effect/turf_decal/trimline/yellow/filled/corner,
/turf/open/floor/oldshuttle,
/area/shuttle/escape)
"nm" = (
/turf/template_noop,
/area/template_noop)
"nT" = (
/obj/machinery/door/airlock/medical/glass,
/turf/open/floor/oldshuttle,
/area/shuttle/escape)
"oe" = (
/obj/machinery/door/airlock/command/glass,
/turf/open/floor/oldshuttle,
/area/shuttle/escape)
"or" = (
/obj/structure/closet{
	icon_state = "oldcloset";
	name = "strange closet";
	enable_door_overlay = 0
	},
/obj/machinery/light/no_nightlight/directional/west,
/turf/open/floor/oldshuttle,
/area/shuttle/escape)
"pb" = (
/obj/effect/turf_decal/trimline/red/filled/line{
	dir = 8
	},
/turf/open/floor/oldshuttle,
/area/shuttle/escape/brig)
"pc" = (
/obj/effect/turf_decal/trimline/blue/filled/corner,
/turf/open/floor/oldshuttle,
/area/shuttle/escape)
"pH" = (
/obj/effect/turf_decal/trimline/blue/filled/line{
	dir = 8
	},
/obj/machinery/iv_drip,
/turf/open/floor/oldshuttle,
/area/shuttle/escape)
"qk" = (
/obj/effect/turf_decal/trimline/red/filled/end{
	dir = 4
	},
/turf/closed/indestructible/oldshuttle,
/area/shuttle/escape)
"qB" = (
/turf/closed/indestructible/oldshuttle/corner,
/area/shuttle/escape)
"rr" = (
/obj/structure/closet{
	icon_state = "oldcloset";
	name = "strange closet";
	enable_door_overlay = 0
	},
/obj/machinery/light/no_nightlight/directional/east,
/turf/open/floor/oldshuttle,
/area/shuttle/escape)
"sP" = (
/turf/closed/indestructible/oldshuttle/corner{
	dir = 1
	},
/area/shuttle/escape)
"ue" = (
/obj/structure/rack,
/obj/effect/turf_decal/trimline/yellow/filled/end{
	dir = 8
	},
/obj/item/storage/toolbox/mechanical/old{
	pixel_x = 3;
	pixel_y = 5
	},
/obj/item/storage/toolbox/emergency/old,
/obj/machinery/light/no_nightlight/directional/west,
/turf/open/floor/oldshuttle,
/area/shuttle/escape)
"us" = (
/obj/effect/turf_decal/trimline/yellow/filled/line{
	dir = 1
	},
/turf/open/floor/oldshuttle,
/area/shuttle/escape)
"uz" = (
/obj/effect/turf_decal/trimline/dark_blue/filled/line,
/obj/effect/turf_decal/trimline/dark_blue/filled/corner{
	dir = 1
	},
/turf/open/floor/oldshuttle,
/area/shuttle/escape)
"vk" = (
/obj/effect/turf_decal/trimline/red/filled/line{
	dir = 10
	},
/obj/structure/chair/old{
	dir = 1
	},
/turf/open/floor/oldshuttle,
/area/shuttle/escape/brig)
"vs" = (
/obj/effect/turf_decal/trimline/blue/filled/line{
	dir = 5
	},
/turf/open/floor/oldshuttle,
/area/shuttle/escape)
"vP" = (
/obj/effect/turf_decal/trimline/red/filled/line{
	dir = 8
	},
/obj/structure/chair/old{
	dir = 4
	},
/turf/open/floor/oldshuttle,
/area/shuttle/escape/brig)
"wk" = (
/obj/machinery/computer/records/medical,
/turf/open/floor/oldshuttle,
/area/shuttle/escape)
"xe" = (
/turf/closed/indestructible/oldshuttle,
/area/shuttle/escape)
"xG" = (
/obj/effect/turf_decal/trimline/red/filled/line{
	dir = 5
	},
/obj/structure/chair/old{
	dir = 8
	},
/turf/open/floor/oldshuttle,
/area/shuttle/escape/brig)
"xN" = (
/obj/effect/turf_decal/trimline/yellow/filled/line{
	dir = 1
	},
/obj/effect/turf_decal/trimline/yellow/filled/corner{
	dir = 8
	},
/turf/open/floor/oldshuttle,
/area/shuttle/escape)
"yA" = (
/obj/machinery/computer/atmos_alert,
/turf/open/floor/oldshuttle,
/area/shuttle/escape)
"zp" = (
/obj/machinery/computer/communications,
/obj/effect/turf_decal/trimline/dark_blue/filled/line{
	dir = 9
	},
/turf/open/floor/oldshuttle,
/area/shuttle/escape)
"Ao" = (
/obj/effect/turf_decal/trimline/red/filled/line{
	dir = 5
	},
/obj/structure/table,
/obj/machinery/recharger{
	pixel_x = -6
	},
/obj/machinery/recharger{
	pixel_x = 6
	},
/turf/open/floor/oldshuttle,
/area/shuttle/escape/brig)
"Ap" = (
/obj/machinery/computer/records/security{
	dir = 4
	},
/obj/effect/turf_decal/trimline/dark_blue/filled/end{
	dir = 8
	},
/obj/machinery/light/no_nightlight/directional/west,
/turf/open/floor/oldshuttle,
/area/shuttle/escape)
"AL" = (
/obj/machinery/power/shuttle_engine/propulsion/burst/left,
/turf/open/floor/plating/airless,
/area/shuttle/escape)
"Bi" = (
/obj/machinery/computer/crew,
/obj/effect/turf_decal/trimline/dark_blue/filled/line{
	dir = 5
	},
/turf/open/floor/oldshuttle,
/area/shuttle/escape)
"Cr" = (
/obj/item/crowbar/large/old,
/turf/open/floor/oldshuttle,
/area/shuttle/escape)
"CH" = (
/obj/machinery/recharge_station,
/obj/effect/turf_decal/trimline/yellow/filled/line{
	dir = 10
	},
/turf/open/floor/oldshuttle,
/area/shuttle/escape)
"CQ" = (
/obj/effect/turf_decal/trimline/red/filled/line{
	dir = 4
	},
/obj/structure/chair/old{
	dir = 8
	},
/turf/open/floor/oldshuttle,
/area/shuttle/escape/brig)
"Dl" = (
/obj/structure/chair/old{
	dir = 1
	},
/obj/machinery/light/no_nightlight/directional/north,
/turf/open/floor/oldshuttle,
/area/shuttle/escape)
"Dr" = (
/obj/effect/turf_decal/trimline/blue/filled/line{
	dir = 4
	},
/turf/open/floor/oldshuttle,
/area/shuttle/escape)
"Ez" = (
/obj/effect/turf_decal/trimline/red/filled/line{
	dir = 10
	},
/obj/structure/chair/old{
	dir = 4
	},
/turf/open/floor/oldshuttle,
/area/shuttle/escape/brig)
"FY" = (
/obj/structure/closet{
	icon_state = "oldcloset";
	name = "strange closet";
	enable_door_overlay = 0
	},
/turf/open/floor/oldshuttle,
/area/shuttle/escape)
"Gs" = (
/obj/effect/turf_decal/trimline/blue/filled/line{
	dir = 6
	},
/obj/structure/table/optable,
/turf/open/floor/oldshuttle,
/area/shuttle/escape)
"Hp" = (
/obj/effect/turf_decal/trimline/blue/filled/line{
	dir = 10
	},
/obj/machinery/computer/operating{
	dir = 4
	},
/turf/open/floor/oldshuttle,
/area/shuttle/escape)
"HH" = (
/obj/effect/turf_decal/trimline/blue/filled/line{
	dir = 6
	},
/obj/structure/rack,
/obj/item/storage/medkit/ancient{
	pixel_y = 6;
	pixel_x = 5
	},
/obj/item/storage/medkit/ancient{
	pixel_y = 1;
	pixel_x = -3
	},
/obj/item/storage/medkit/ancient{
	pixel_y = 1;
	pixel_x = 5
	},
/obj/structure/window/reinforced/spawner{
	dir = 1
	},
/turf/open/floor/oldshuttle,
/area/shuttle/escape)
"IN" = (
/obj/machinery/power/shuttle_engine/propulsion/burst,
/obj/structure/table,
/turf/open/floor/plating/airless,
/area/shuttle/escape)
"Jo" = (
/turf/open/floor/oldshuttle,
/area/shuttle/escape/brig)
"JQ" = (
/obj/effect/turf_decal/trimline/yellow/filled/line,
/turf/open/floor/oldshuttle,
/area/shuttle/escape)
"Ke" = (
/obj/effect/turf_decal/trimline/blue/filled/line{
	dir = 8
	},
/obj/structure/table,
/obj/item/storage/backpack/duffelbag/med/surgery{
	pixel_y = 6
	},
/obj/item/clothing/gloves/latex/nitrile{
	pixel_y = 4
	},
/obj/machinery/light/no_nightlight/directional/west,
/turf/open/floor/oldshuttle,
/area/shuttle/escape)
"Lq" = (
/obj/effect/turf_decal/trimline/red/filled/line{
	dir = 4
	},
/obj/structure/chair/old{
	dir = 8
	},
/obj/machinery/light/no_nightlight/directional/east,
/turf/open/floor/oldshuttle,
/area/shuttle/escape/brig)
"LN" = (
/turf/open/floor/oldshuttle,
/area/shuttle/escape)
"MG" = (
/obj/effect/turf_decal/trimline/yellow/filled/end{
	dir = 4;
	pixel_y = 0
	},
/obj/machinery/suit_storage_unit/void_old,
/obj/machinery/light/no_nightlight/directional/east,
/turf/open/floor/oldshuttle,
/area/shuttle/escape)
"NY" = (
/obj/structure/chair/old{
	dir = 4
	},
/obj/effect/turf_decal/trimline/dark_blue/filled/line,
/obj/effect/turf_decal/trimline/dark_blue/filled/line{
	dir = 1
	},
/turf/open/floor/oldshuttle,
/area/shuttle/escape)
"OX" = (
/obj/effect/turf_decal/trimline/red/filled/line{
	dir = 9
	},
/turf/open/floor/oldshuttle,
/area/shuttle/escape/brig)
"PC" = (
/obj/effect/turf_decal/trimline/blue/filled/line{
	dir = 9
	},
/obj/machinery/stasis{
	dir = 1
	},
/turf/open/floor/oldshuttle,
/area/shuttle/escape)
"QJ" = (
/obj/machinery/door/airlock/public/glass,
/turf/open/floor/oldshuttle,
/area/shuttle/escape)
"Sg" = (
/turf/closed/indestructible/oldshuttle/corner{
	dir = 4
	},
/area/shuttle/escape)
"Sj" = (
/obj/structure/chair/old{
	dir = 1
	},
/obj/effect/turf_decal/trimline/dark_blue/filled/line{
	dir = 4
	},
/turf/open/floor/oldshuttle,
/area/shuttle/escape)
"So" = (
/turf/open/floor/iron/stairs/old{
	dir = 1
	},
/area/shuttle/escape)
"Su" = (
/obj/structure/chair/old{
	dir = 1
	},
/obj/effect/turf_decal/trimline/dark_blue/filled/line{
	dir = 8
	},
/turf/open/floor/oldshuttle,
/area/shuttle/escape)
"TE" = (
/turf/closed/indestructible/oldshuttle/corner{
	dir = 8
	},
/area/shuttle/escape)
"TH" = (
/obj/machinery/door/airlock/security/glass,
/obj/effect/mapping_helpers/airlock/access/all/security/general,
/turf/open/floor/oldshuttle,
/area/shuttle/escape)
"TR" = (
/obj/effect/turf_decal/trimline/blue/filled/corner{
	dir = 1
	},
/turf/open/floor/oldshuttle,
/area/shuttle/escape)
"Uh" = (
/obj/structure/chair/old{
	dir = 1
	},
/turf/open/floor/oldshuttle,
/area/shuttle/escape)
"UQ" = (
/obj/effect/turf_decal/trimline/blue/filled/line{
	dir = 1
	},
/obj/machinery/light/no_nightlight/directional/north,
/turf/open/floor/oldshuttle,
/area/shuttle/escape)
"Vk" = (
/obj/effect/turf_decal/trimline/blue/filled/line{
	dir = 6
	},
/obj/machinery/sleeper/old,
/turf/open/floor/oldshuttle,
/area/shuttle/escape)
"Wg" = (
/obj/effect/turf_decal/trimline/red/filled/line{
	dir = 6
	},
/obj/structure/table,
/obj/item/restraints/handcuffs,
/obj/item/assembly/flash/handheld{
	pixel_x = -7
	},
/turf/open/floor/oldshuttle,
/area/shuttle/escape/brig)
"Wz" = (
/obj/effect/turf_decal/trimline/dark_blue/filled/line,
/turf/open/floor/oldshuttle,
/area/shuttle/escape)
"Xf" = (
/obj/machinery/computer/station_alert{
	dir = 8
	},
/obj/effect/turf_decal/trimline/dark_blue/filled/end{
	dir = 4
	},
/obj/machinery/light/no_nightlight/directional/east,
/turf/open/floor/oldshuttle,
/area/shuttle/escape)
"ZC" = (
/obj/machinery/power/shuttle_engine/propulsion/burst,
/turf/open/floor/plating/airless,
/area/shuttle/escape)

(1,1,1) = {"
nm
nm
nm
nm
nm
nm
nm
qB
xe
xe
xe
xe
bk
ZC
nm
"}
(2,1,1) = {"
nm
nm
nm
nm
nm
qB
xe
xe
PC
pH
Ke
Hp
bk
bk
jz
"}
(3,1,1) = {"
nm
nm
nm
nm
nm
xe
PC
pH
TR
pc
Dr
Gs
bk
bk
jz
"}
(4,1,1) = {"
nm
nm
nm
nm
ga
bk
UQ
LN
pc
HH
xe
xe
bk
ef
nm
"}
(5,1,1) = {"
nm
nm
nm
nm
qB
xe
vs
kq
Vk
xe
sP
nm
nm
nm
nm
"}
(6,1,1) = {"
nm
nm
qB
xe
xe
xe
nT
xe
xe
xe
xe
xe
xe
TE
nm
"}
(7,1,1) = {"
nm
qB
xe
Ap
xe
FY
LN
FY
or
FY
FY
xe
ue
xe
TE
"}
(8,1,1) = {"
qB
xe
wk
ir
xe
Uh
Uh
Uh
Uh
Uh
Uh
xe
jC
xe
xe
"}
(9,1,1) = {"
xe
zp
Su
uz
xe
Dl
Uh
Uh
Uh
Uh
qB
xe
xN
CH
xe
"}
(10,1,1) = {"
xe
jA
Uh
Wz
oe
LN
LN
LN
LN
LN
So
QJ
us
JQ
je
"}
(11,1,1) = {"
xe
Bi
Sj
mk
xe
Dl
Uh
Uh
Uh
Uh
TE
xe
mn
jk
xe
"}
(12,1,1) = {"
Sg
xe
yA
NY
xe
Uh
Uh
Uh
Uh
Uh
Uh
xe
aq
xe
xe
"}
(13,1,1) = {"
nm
Sg
xe
Xf
xe
FY
Cr
FY
rr
FY
FY
xe
MG
xe
sP
"}
(14,1,1) = {"
nm
nm
Sg
xe
xe
xe
TH
xe
xe
xe
xe
xe
xe
sP
nm
"}
(15,1,1) = {"
nm
nm
nm
nm
Sg
xe
OX
vP
Ez
xe
TE
nm
nm
nm
nm
"}
(16,1,1) = {"
nm
nm
nm
nm
ga
bk
kv
Jo
bB
vk
xe
xe
bk
AL
nm
"}
(17,1,1) = {"
nm
nm
nm
nm
nm
xe
xG
CQ
kW
bB
pb
vk
bk
bk
ZC
"}
(18,1,1) = {"
nm
nm
nm
nm
nm
Sg
xe
xe
Ao
CQ
Lq
Wg
bk
bk
IN
"}
(19,1,1) = {"
nm
nm
nm
nm
nm
nm
nm
Sg
xe
xe
xe
qk
bk
ZC
nm
"}
