//MAP CONVERTED BY dmm2tgm.py THIS HEADER COMMENT PREVENTS RECONVERSION, DO NOT REMOVE
"a" = (
/obj/effect/spawner/structure/window/reinforced/plasma/plastitanium,
/turf/open/floor/plating,
/area/shuttle/syndicate_drop_pod)
"c" = (
/obj/machinery/porta_turret/centcom_shuttle{
	dir = 5
	},
/turf/closed/wall/mineral/plastitanium,
/area/shuttle/syndicate_drop_pod)
"g" = (
/obj/machinery/porta_turret/centcom_shuttle{
	dir = 10
	},
/turf/closed/wall/mineral/plastitanium/nodiagonal,
/area/shuttle/syndicate_drop_pod)
"i" = (
/obj/effect/turf_decal/stripes/red/line{
	dir = 8
	},
/obj/effect/turf_decal/stripes/red/line{
	dir = 4
	},
/turf/open/floor/mineral/plastitanium,
/area/shuttle/syndicate_drop_pod)
"j" = (
/obj/structure/railing,
/obj/structure/chair/comfy/shuttle{
	dir = 4;
	name = "tactical chair"
	},
/obj/machinery/light/red/dim/directional/west,
/turf/open/floor/mineral/plastitanium/red,
/area/shuttle/syndicate_drop_pod)
"k" = (
/obj/effect/turf_decal/stripes/red/line{
	dir = 4
	},
/obj/effect/turf_decal/stripes/red/line{
	dir = 8
	},
/turf/open/floor/mineral/plastitanium,
/area/shuttle/syndicate_drop_pod)
"n" = (
/obj/effect/turf_decal/stripes/red/line{
	dir = 8
	},
/obj/effect/turf_decal/stripes/red/line{
	dir = 4
	},
/obj/machinery/holopad,
/turf/open/floor/mineral/plastitanium,
/area/shuttle/syndicate_drop_pod)
"w" = (
/turf/closed/wall/mineral/plastitanium/nodiagonal,
/area/shuttle/syndicate_drop_pod)
"x" = (
/turf/template_noop,
/area/template_noop)
"z" = (
/obj/machinery/porta_turret/centcom_shuttle{
	dir = 6
	},
/turf/closed/wall/mineral/plastitanium/nodiagonal,
/area/shuttle/syndicate_drop_pod)
"D" = (
/obj/structure/table/reinforced,
/obj/item/storage/medkit/tactical,
/turf/open/floor/mineral/plastitanium,
/area/shuttle/syndicate_drop_pod)
"E" = (
/obj/machinery/porta_turret/centcom_shuttle{
	dir = 9
	},
/turf/closed/wall/mineral/plastitanium,
/area/shuttle/syndicate_drop_pod)
"G" = (
/obj/machinery/door/airlock/external{
	id_tag = "SBC_corvette_bolt";
	name = "Syndicate Corvette Airlock"
	},
/obj/docking_port/stationary{
	dwidth = 4;
	height = 5;
	shuttle_id = "syndie_waystation_safehouse";
	name = "NSS Eclipse";
	roundstart_template = /datum/map_template/shuttle/ruin/syndicate_fighter_shiv;
	width = 9;
	dir = 2
	},
/turf/open/floor/mineral/plastitanium,
/area/shuttle/syndicate_drop_pod)
"H" = (
/obj/effect/turf_decal/stripes/red/end,
/obj/structure/chair/comfy/shuttle{
	dir = 1;
	name = "tactical chair"
	},
/turf/open/floor/mineral/plastitanium,
/area/shuttle/syndicate_drop_pod)
"I" = (
/obj/structure/chair/comfy/shuttle{
	dir = 8;
	name = "tactical chair"
	},
/turf/open/floor/mineral/plastitanium/red,
/area/shuttle/syndicate_drop_pod)
"K" = (
/obj/structure/chair/comfy/shuttle{
	dir = 4;
	name = "tactical chair"
	},
/turf/open/floor/mineral/plastitanium/red,
/area/shuttle/syndicate_drop_pod)
"O" = (
/obj/machinery/computer/shuttle/syndicate_drop_pod{
	dir = 8
	},
/turf/open/floor/mineral/plastitanium,
/area/shuttle/syndicate_drop_pod)
"R" = (
/turf/closed/wall/mineral/plastitanium,
/area/shuttle/syndicate_drop_pod)
"V" = (
/obj/structure/railing,
/obj/structure/chair/comfy/shuttle{
	dir = 8;
	name = "tactical chair"
	},
/obj/machinery/light/red/dim/directional/east,
/turf/open/floor/mineral/plastitanium/red,
/area/shuttle/syndicate_drop_pod)
"Y" = (
/obj/machinery/power/shuttle_engine/propulsion,
/turf/open/floor/plating,
/area/shuttle/syndicate_drop_pod)

(1,1,1) = {"
x
R
w
w
w
w
Y
"}
(2,1,1) = {"
E
R
K
j
D
w
g
"}
(3,1,1) = {"
G
k
i
n
i
H
a
"}
(4,1,1) = {"
c
R
I
V
O
w
z
"}
(5,1,1) = {"
x
R
w
w
w
w
Y
"}
